5 15
###############
#   #    D @ G#
#A#    ##   # #
#   #    D   G#
###############

