31699S6
59
###############
#   # A@   @  #
# #  @ ##   # #
#   #         #
###############
